05 05 05 05 05 05 05 05 05 05 05 05 05 05 05 05 05 05 05 05 05 05 05 00 00 00 00 05 05 05 05 05 05 05 05 05 05 05 05 05 05 05 05 05 05 05 05 05 05 05
05 02 02 03 00 00 00 00 00 00 00 00 00 00 00 00 05 00 00 00 00 00 03 02 02 02 02 03 00 00 00 00 00 00 00 05 00 00 00 00 00 00 00 00 00 00 03 02 02 05
05 02 02 02 03 00 00 00 00 00 00 00 00 00 00 00 00 00 00 00 00 00 03 02 02 02 02 03 00 00 00 00 00 00 00 00 00 00 00 05 00 00 00 00 00 03 02 02 02 05
05 03 02 02 02 03 00 00 00 00 00 00 00 00 00 00 00 00 00 00 00 00 03 02 02 02 02 03 00 00 00 05 00 00 00 00 00 00 00 00 00 00 00 00 03 02 02 02 03 05
05 00 03 02 02 02 03 00 00 00 00 00 00 00 05 00 00 00 00 00 00 00 03 02 02 02 02 03 00 00 00 00 00 00 00 00 00 05 00 00 00 00 00 03 02 02 02 03 00 05
05 00 00 03 02 02 02 03 00 00 00 00 00 00 00 00 00 00 00 00 00 00 03 02 02 02 02 03 00 00 00 00 00 00 00 00 00 00 00 00 00 00 03 02 02 02 03 00 00 05
05 00 00 00 03 02 02 02 03 00 00 00 00 00 00 00 00 05 00 00 00 00 03 02 02 02 02 03 00 00 00 00 05 00 00 00 00 00 00 00 00 03 02 02 02 03 00 00 00 05
05 00 00 00 00 03 02 02 02 03 00 00 00 00 00 00 00 00 00 00 00 00 03 02 02 02 02 03 00 00 00 00 00 00 00 00 00 00 00 00 03 02 02 02 03 00 00 00 00 05
05 00 00 00 00 00 03 02 02 02 03 00 00 00 00 00 00 00 00 00 00 00 03 02 02 02 02 03 00 00 00 00 00 00 00 05 00 00 00 03 02 02 02 03 00 00 00 00 00 05
05 00 00 00 00 00 00 03 02 02 02 03 00 00 00 00 05 00 00 05 00 00 03 02 02 02 02 03 00 00 05 00 00 00 00 00 00 00 03 02 02 02 03 00 00 00 00 00 00 05
05 00 00 00 00 00 00 00 03 02 02 02 03 00 00 00 00 00 00 00 00 00 03 02 02 02 02 03 00 00 00 00 00 00 00 00 00 03 02 02 02 03 00 00 05 00 00 00 00 05
05 00 00 00 00 00 00 00 00 03 02 02 02 03 00 00 00 00 00 00 00 00 03 02 02 02 02 03 05 00 00 00 00 00 00 00 03 02 02 02 03 00 00 00 00 00 00 00 00 05
05 00 05 00 00 00 00 00 00 00 03 02 02 02 03 00 00 00 00 00 00 00 03 02 02 02 02 03 00 00 00 00 00 00 00 03 02 02 02 03 00 00 00 00 00 00 00 00 00 05
05 00 00 00 00 00 00 00 00 00 00 03 02 02 02 03 00 00 00 00 00 00 03 02 02 02 02 03 00 00 00 00 00 00 03 02 02 02 03 00 00 00 00 00 00 00 00 00 00 05
05 00 00 00 00 05 00 00 00 00 00 00 03 02 02 02 03 00 00 05 00 00 03 02 02 02 02 03 00 00 00 00 00 03 02 02 02 03 00 05 00 00 00 00 00 00 00 00 00 05
05 00 05 00 00 00 00 00 00 00 00 00 00 03 02 02 02 03 00 00 00 00 03 02 02 02 02 03 00 00 00 00 03 02 02 02 03 00 00 00 00 00 00 00 00 00 00 00 00 05
05 00 00 00 00 00 00 05 00 00 00 00 00 00 03 02 02 02 03 03 03 03 03 02 02 02 02 03 03 03 03 03 02 02 02 03 00 00 00 00 00 00 05 00 00 00 00 00 00 05
05 00 00 00 05 00 00 00 00 00 00 00 00 00 00 03 02 02 02 02 02 02 02 02 02 02 02 02 02 02 02 02 02 02 03 00 00 00 00 00 00 00 00 00 00 00 00 00 00 05
05 00 00 00 00 00 00 00 05 00 00 00 00 00 00 00 03 02 02 02 02 02 02 02 02 02 02 02 02 02 02 02 02 03 00 00 00 00 00 00 00 00 00 00 00 00 00 00 00 05
05 00 05 00 00 00 00 00 00 00 00 00 00 00 00 00 03 02 02 02 04 01 01 01 01 04 01 01 01 01 02 02 02 03 00 00 00 00 00 00 00 00 00 00 00 00 00 00 00 05
05 00 00 00 00 00 05 00 00 00 00 00 00 00 00 00 03 02 02 01 01 01 04 01 01 01 01 01 04 01 01 02 02 03 00 00 00 00 00 05 00 00 00 00 00 00 00 00 00 05
05 00 00 00 00 00 00 00 00 00 00 00 00 00 00 00 03 02 02 01 01 01 01 01 01 01 01 01 01 01 01 02 02 03 00 05 00 00 00 00 00 00 00 00 00 00 00 00 00 05
05 03 03 03 03 03 03 03 03 03 03 03 03 03 03 03 03 02 02 01 04 01 01 01 01 04 01 01 01 04 01 02 02 03 03 03 03 03 03 03 03 03 03 03 03 03 03 03 03 05
00 02 02 02 02 02 02 02 02 02 02 02 02 02 02 02 02 02 02 01 01 01 04 01 01 01 01 01 01 01 01 02 02 02 02 02 02 02 02 02 02 02 02 02 02 02 02 02 02 00
00 02 02 02 02 02 02 02 02 02 02 02 02 02 02 02 02 02 02 01 01 01 01 01 04 01 04 01 04 01 01 02 02 02 02 02 02 02 02 02 02 02 02 02 02 02 02 02 02 00
00 02 02 02 02 02 02 02 02 02 02 02 02 02 02 02 02 02 02 01 04 01 01 04 05 01 01 01 01 01 01 02 02 02 02 02 02 02 02 02 02 02 02 02 02 02 02 02 02 00
00 02 02 02 02 02 02 02 02 02 02 02 02 02 02 02 02 02 02 01 01 01 01 01 01 04 01 04 01 01 01 02 02 02 02 02 02 02 02 02 02 02 02 02 02 02 02 02 02 00
05 03 03 03 03 03 03 03 03 03 03 03 03 03 03 03 03 02 02 04 01 01 04 01 01 01 01 01 01 04 01 02 02 03 03 03 03 03 03 03 03 03 03 03 03 03 03 03 03 05
05 00 00 00 00 00 00 00 00 00 00 00 00 00 00 00 03 02 02 01 04 01 01 01 04 01 04 01 01 01 01 02 02 03 00 00 00 00 00 00 00 00 00 00 00 00 00 00 00 05
05 05 05 05 05 05 05 05 00 00 00 00 00 00 00 00 03 02 02 01 01 04 01 01 01 01 01 01 04 01 01 02 02 03 00 00 00 00 00 00 00 00 00 00 00 00 00 00 00 05
05 05 05 05 05 05 05 05 00 00 00 00 00 00 00 00 03 02 02 02 04 01 01 04 01 04 01 01 04 01 02 02 02 03 00 05 00 00 00 00 00 00 00 00 00 00 00 00 05 05
05 05 05 05 05 05 05 05 00 00 00 00 00 00 00 00 03 02 02 02 02 02 02 02 02 02 02 02 02 02 02 02 02 03 00 00 00 00 00 00 00 00 05 00 00 00 00 00 00 05
05 05 05 05 00 05 05 05 00 00 00 00 00 00 00 03 02 02 02 02 02 02 02 02 02 02 02 02 02 02 02 02 02 02 03 00 00 00 00 00 00 00 00 00 00 00 00 00 00 05
05 05 05 05 05 05 05 05 00 00 00 00 00 00 03 02 02 02 03 03 03 03 03 02 02 02 02 03 03 03 03 03 02 02 02 03 00 00 00 00 00 00 00 00 00 00 00 00 00 05
05 05 05 05 05 05 05 05 00 00 00 00 00 03 02 02 02 03 00 00 00 00 03 02 02 02 02 03 00 05 00 00 03 02 02 02 03 00 00 00 00 00 00 00 00 00 00 00 00 05
05 05 05 05 05 05 05 05 00 00 00 00 03 02 02 02 03 00 00 00 00 00 03 02 02 02 02 03 00 00 00 00 00 03 02 02 02 03 00 00 00 00 05 00 00 00 00 00 00 05
05 05 05 05 05 05 05 05 00 00 00 03 02 02 02 03 00 00 00 05 00 00 03 02 02 02 02 03 00 00 00 00 00 00 03 02 02 02 03 00 00 00 00 00 00 00 00 00 00 05
05 00 00 00 00 00 00 00 00 00 03 02 02 02 03 00 00 00 00 00 00 00 03 02 02 02 02 03 00 00 05 00 00 00 00 03 02 02 02 03 00 00 00 00 00 00 00 00 00 05
05 00 00 00 00 00 00 00 00 03 02 02 02 03 00 05 00 00 00 00 00 00 03 02 02 02 02 03 00 00 00 00 00 00 00 00 03 02 02 02 03 00 00 00 00 00 00 00 00 05
05 00 00 05 00 00 00 00 03 02 02 02 03 00 00 00 00 05 00 00 00 00 03 02 02 02 02 03 00 00 00 00 00 00 00 00 00 03 02 02 02 03 00 00 00 00 00 05 00 05
05 00 00 00 00 00 00 03 02 02 02 03 00 00 00 00 00 00 00 00 00 00 03 02 02 02 02 03 00 00 00 00 05 00 00 00 00 00 03 02 02 02 03 00 00 00 00 00 00 05
05 00 00 00 00 00 03 02 02 02 03 00 00 00 00 00 00 00 00 00 00 00 03 02 02 02 02 03 00 00 00 00 00 00 00 00 00 00 00 03 02 02 02 03 00 00 00 00 00 05
05 00 00 00 00 03 02 02 02 03 00 00 00 00 00 00 00 00 00 00 00 00 03 02 02 02 02 03 00 00 00 00 00 00 00 00 00 00 00 00 03 02 02 02 03 00 00 00 00 05
05 00 00 00 03 02 02 02 03 00 00 00 00 00 00 00 00 00 00 00 00 00 03 02 02 02 02 03 00 05 00 00 00 00 00 00 00 00 00 00 00 03 02 02 02 03 00 00 00 05
05 00 00 03 02 02 02 03 00 00 00 00 00 00 00 00 00 00 00 00 00 00 03 02 02 02 02 03 00 00 00 00 00 00 00 00 00 00 00 05 00 00 03 02 02 02 03 00 00 05
05 00 03 02 02 02 03 00 00 00 00 00 00 00 00 00 00 00 00 00 00 00 03 02 02 02 02 03 00 00 00 00 00 00 05 00 00 00 00 00 00 00 00 03 02 02 02 03 00 05
05 03 02 02 02 03 00 00 00 00 00 00 00 00 00 00 00 00 00 00 00 00 03 02 02 02 02 03 00 00 00 00 00 00 00 00 00 00 00 00 00 00 00 00 03 02 02 02 03 05
05 02 02 02 03 00 00 00 00 00 00 00 00 00 00 00 00 00 00 00 00 00 03 02 02 02 02 03 00 00 00 00 00 00 00 00 00 00 00 00 00 00 00 00 00 03 02 02 02 05
05 02 02 03 00 00 00 00 00 00 00 00 00 00 00 00 00 00 00 00 00 00 03 02 02 02 02 03 00 00 00 00 00 00 00 00 00 00 00 00 00 00 00 00 00 00 03 02 02 05
05 05 05 05 05 05 05 05 05 05 05 05 05 05 05 05 05 05 05 05 05 05 05 00 00 00 00 05 05 05 05 05 05 05 05 05 05 05 05 05 05 05 05 05 05 05 05 05 05 01